40 45
700 2240
00 00 00 00 00 00 00 00 00 00 00 00 00 00 00 00 00 00 00 00 00 00 00 00 00 00 00 00 00 00 00 00 00 00 00 00 00 00 00 00
00 00 00 00 00 00 00 00 00 00 00 00 00 00 00 00 00 00 00 00 00 00 00 00 00 00 00 00 00 00 00 00 00 00 00 00 00 00 00 00
00 00 00 00 00 00 00 00 00 00 00 00 00 00 00 00 00 00 00 00 00 00 00 00 00 00 00 00 00 00 00 00 00 00 00 00 00 00 00 00
00 00 00 00 00 00 00 14 18 18 18 18 18 18 18 15 00 00 00 00 00 00 00 00 03 03 03 03 03 03 03 03 03 00 00 00 00 00 00 00
00 00 00 00 00 00 00 21 06 10 10 10 10 10 07 19 00 00 00 00 00 00 00 00 03 05 05 05 05 05 05 05 03 00 00 00 00 00 00 00
00 00 00 00 00 00 00 21 13 05 05 05 05 05 11 19 03 03 03 03 03 03 03 03 03 05 05 05 05 05 05 05 03 00 00 00 00 00 00 00
00 00 00 00 00 00 00 21 13 05 05 05 05 05 11 04 05 05 05 05 05 05 05 05 04 05 05 05 05 05 05 05 04 00 00 00 00 00 00 00
00 00 00 00 00 00 00 21 13 05 05 05 05 05 11 04 05 05 05 05 05 05 05 05 04 05 05 05 05 05 05 05 04 00 00 00 00 00 00 00
00 00 00 00 00 00 00 21 13 05 05 05 05 05 11 04 05 05 05 05 05 05 05 05 04 05 05 05 05 05 05 05 04 00 00 00 00 00 00 00
00 00 00 00 00 00 00 21 13 05 05 05 05 05 11 19 03 03 03 03 03 03 03 03 03 05 05 05 05 05 05 05 03 00 00 00 00 00 00 00
00 00 00 00 00 00 00 21 09 12 12 12 12 12 08 19 00 00 00 00 00 00 00 00 03 05 05 05 05 05 05 05 03 00 00 00 00 00 00 00
00 00 00 00 00 00 00 17 20 20 04 04 04 20 20 16 00 00 00 00 00 00 00 00 03 03 03 03 03 03 03 03 03 00 00 00 00 00 00 00
00 00 00 00 00 00 00 00 00 21 06 10 07 19 00 00 00 00 00 00 00 00 00 00 00 00 00 00 00 00 00 00 00 00 00 00 00 00 00 00
00 00 00 00 00 00 00 00 00 21 13 05 11 19 00 00 00 00 00 00 00 00 00 00 00 00 00 00 00 00 00 00 00 00 00 00 00 00 00 00
00 00 00 00 00 00 00 00 00 21 13 05 11 19 00 00 00 00 00 00 00 00 00 00 00 00 00 00 00 00 00 00 00 00 00 00 00 00 00 00
00 00 00 00 00 00 00 00 00 21 13 05 11 19 00 00 00 00 00 00 00 00 00 00 00 00 00 00 00 00 00 00 00 00 00 00 00 00 00 00
00 00 00 00 00 00 00 00 00 21 13 05 11 19 00 00 00 00 00 00 00 00 00 00 00 00 00 00 00 00 00 00 00 00 00 00 00 00 00 00
00 00 00 00 00 00 00 00 00 21 09 12 08 19 00 00 00 00 00 00 00 00 00 00 00 00 00 00 00 00 00 00 00 00 00 00 00 00 00 00
00 00 00 00 00 00 00 14 18 18 04 04 04 18 18 15 00 00 00 00 00 00 00 00 00 00 00 00 00 00 00 00 00 00 00 00 00 00 00 00
00 00 00 00 00 00 00 21 06 10 10 10 10 10 07 19 00 00 00 00 00 00 00 00 00 00 00 00 00 00 00 00 00 00 00 00 00 00 00 00
00 00 00 00 00 00 00 21 13 05 05 05 05 05 11 19 00 00 00 00 00 00 00 00 00 00 00 00 00 00 00 00 00 00 00 00 00 00 00 00
00 00 00 00 00 00 00 21 13 05 05 05 05 05 11 19 00 00 00 00 00 00 00 00 00 00 00 00 00 00 00 00 00 00 00 00 00 00 00 00
00 00 00 00 00 00 00 21 13 05 05 05 05 05 11 19 00 00 00 00 00 00 00 00 00 00 00 00 00 00 00 00 00 00 00 00 00 00 00 00
00 00 00 00 00 00 00 21 13 05 05 05 05 05 11 19 00 00 00 00 00 00 00 00 00 00 00 00 00 00 00 00 00 00 00 00 00 00 00 00
00 00 00 00 00 00 00 21 13 05 05 05 05 05 11 19 00 00 00 00 00 00 00 00 00 00 00 00 00 00 00 00 00 00 00 00 00 00 00 00
00 00 00 00 00 00 00 21 09 12 12 12 12 12 08 19 00 00 00 00 00 00 00 00 00 00 00 00 00 00 00 00 00 00 00 00 00 00 00 00
00 00 00 00 00 00 00 17 20 20 04 04 04 20 20 16 00 00 00 00 00 00 00 00 00 00 00 00 00 00 00 00 00 00 00 00 00 00 00 00
00 00 00 00 00 00 00 00 00 21 06 10 07 19 00 00 00 00 00 00 00 00 00 00 00 00 00 00 00 00 00 00 00 00 00 00 00 00 00 00
00 00 00 00 00 00 00 00 00 21 13 05 11 19 00 00 00 00 00 00 00 00 00 00 00 00 00 00 00 00 00 00 00 00 00 00 00 00 00 00
00 00 00 00 00 00 00 00 00 21 13 05 11 19 00 00 00 00 00 00 00 00 00 00 00 00 00 00 00 00 00 00 00 00 00 00 00 00 00 00
00 00 00 00 00 00 00 00 00 21 13 05 11 19 00 00 00 00 00 00 00 00 00 00 00 00 00 00 00 00 00 00 00 00 00 00 00 00 00 00
00 00 00 00 00 00 00 00 00 21 13 05 11 19 00 00 00 00 00 00 00 00 00 00 00 00 00 00 00 00 00 00 00 00 00 00 00 00 00 00
00 00 00 00 00 00 00 00 00 21 09 12 08 19 00 00 00 00 00 00 00 00 00 00 00 00 00 00 00 00 00 00 00 00 00 00 00 00 00 00
00 00 00 00 00 00 00 14 18 18 04 04 04 18 18 15 00 00 00 00 00 00 00 00 00 00 00 00 00 00 00 00 00 00 00 00 00 00 00 00
00 00 00 00 00 00 00 21 06 10 10 10 10 10 07 19 00 00 00 00 00 00 00 00 00 00 00 00 00 00 00 00 00 00 00 00 00 00 00 00
00 00 00 00 00 00 00 21 13 05 05 05 05 05 11 19 00 00 00 00 00 00 00 00 00 00 00 00 00 00 00 00 00 00 00 00 00 00 00 00
00 00 00 00 00 00 00 21 13 05 05 05 05 05 11 19 00 00 00 00 00 00 00 00 00 00 00 00 00 00 00 00 00 00 00 00 00 00 00 00
00 00 00 00 00 00 00 21 13 05 05 05 05 05 11 19 00 00 00 00 00 00 00 00 00 00 00 00 00 00 00 00 00 00 00 00 00 00 00 00
00 00 00 00 00 00 00 21 13 05 05 05 05 05 11 19 00 00 00 00 00 00 00 00 00 00 00 00 00 00 00 00 00 00 00 00 00 00 00 00
00 00 00 00 00 00 00 21 13 05 05 05 05 05 11 19 00 00 00 00 00 00 00 00 00 00 00 00 00 00 00 00 00 00 00 00 00 00 00 00
00 00 00 00 00 00 00 21 09 12 12 12 12 12 08 19 00 00 00 00 00 00 00 00 00 00 00 00 00 00 00 00 00 00 00 00 00 00 00 00
00 00 00 00 00 00 00 17 20 20 20 20 20 20 20 16 00 00 00 00 00 00 00 00 00 00 00 00 00 00 00 00 00 00 00 00 00 00 00 00
00 00 00 00 00 00 00 00 00 00 00 00 00 00 00 00 00 00 00 00 00 00 00 00 00 00 00 00 00 00 00 00 00 00 00 00 00 00 00 00
00 00 00 00 00 00 00 00 00 00 00 00 00 00 00 00 00 00 00 00 00 00 00 00 00 00 00 00 00 00 00 00 00 00 00 00 00 00 00 00
00 00 00 00 00 00 00 00 00 00 00 00 00 00 00 00 00 00 00 00 00 00 00 00 00 00 00 00 00 00 00 00 00 00 00 00 00 00 00 00