90 70
600 1248
00 00 00 00 00 00 00 00 00 00 00 00 00 00 00 00 00 00 00 00 00 00 00 00 00 00 00 00 00 00 00 00 00 00 00 00 00 00 00 00 00 00 00 00 00 00 00 00 00 00 00 00 00 00 00 00 00 00 00 00 00 00 00 00 00 00 00 00 00 00 00 00 00 00 00 00 00 00 00 00 00 00 00 00 00 00 00 00 00 00
00 00 00 00 00 00 00 00 00 00 00 00 00 00 00 00 00 00 00 00 00 00 00 00 00 00 00 00 00 00 00 00 00 00 00 00 00 00 00 00 00 00 00 00 00 00 00 00 00 00 00 00 00 00 00 00 00 00 00 00 00 00 00 00 00 00 00 00 00 00 00 00 00 00 00 00 00 00 00 00 00 00 00 00 00 00 00 00 00 00
00 00 00 00 00 00 00 00 00 00 00 00 00 00 00 00 00 00 00 00 00 00 00 00 00 00 00 00 00 00 00 00 00 00 00 00 00 00 00 00 00 00 00 00 00 00 00 00 00 00 00 00 00 00 00 00 00 00 00 00 00 00 00 00 00 00 00 00 00 00 00 00 00 00 00 00 00 00 00 00 00 00 00 00 00 00 00 00 00 00
00 00 00 00 00 00 00 00 00 00 00 00 00 00 00 00 00 00 00 00 00 00 00 00 00 00 00 14 18 18 18 18 18 15 00 00 00 00 00 00 00 00 00 00 00 00 00 00 00 00 00 00 00 00 00 00 00 00 00 00 00 00 00 00 00 00 00 00 00 00 00 00 00 00 00 00 00 00 00 00 00 00 00 00 00 00 00 00 00 00
00 00 00 00 00 00 00 00 00 00 00 00 00 00 00 00 00 00 00 00 00 00 00 00 00 00 00 21 06 10 10 10 07 19 00 00 00 00 00 00 00 00 00 00 00 00 00 00 00 00 00 00 00 00 00 00 00 00 00 00 00 00 00 00 00 00 00 00 00 00 00 00 00 00 00 00 00 00 00 00 00 00 00 00 00 00 00 00 00 00
00 00 00 00 00 00 00 00 00 00 00 00 00 00 00 00 00 00 00 00 00 00 00 00 00 00 00 21 13 05 05 05 11 19 00 00 00 00 00 00 00 00 00 00 00 00 00 00 00 00 00 00 00 00 00 00 00 00 00 00 00 00 00 00 00 00 00 00 00 00 00 00 00 00 00 00 00 00 00 00 00 00 00 00 00 00 00 00 00 00
00 00 00 00 00 00 00 00 00 00 00 00 00 00 00 00 00 00 00 00 00 00 00 00 00 00 00 21 13 05 05 05 11 19 00 00 00 00 00 00 00 00 00 00 00 00 00 00 00 00 00 00 00 00 00 00 00 00 00 00 00 00 00 00 00 00 00 00 00 00 00 00 00 00 00 00 00 00 00 00 00 00 00 00 00 00 00 00 00 00
00 00 00 00 00 00 00 00 00 00 00 00 00 00 00 00 00 00 00 00 00 00 00 00 00 00 00 21 09 12 12 12 08 19 00 00 00 00 00 00 00 00 00 00 00 00 00 00 00 00 00 00 00 00 00 00 00 00 00 00 00 00 00 00 00 00 00 00 00 00 00 00 00 00 00 00 00 00 00 00 00 00 00 00 00 00 00 00 00 00
00 00 00 00 00 00 00 00 00 00 00 00 00 00 00 00 00 00 00 00 00 00 00 00 00 00 00 17 20 04 04 04 20 16 00 00 00 00 00 00 00 00 00 00 00 00 00 00 00 00 00 00 00 00 00 00 00 00 00 00 00 00 00 00 00 00 00 00 00 00 00 00 00 00 00 00 00 00 00 00 00 00 00 00 00 00 00 00 00 00
00 00 00 00 00 00 00 00 00 00 00 00 00 00 00 00 00 00 00 00 00 00 00 00 00 00 00 00 21 06 10 07 19 00 00 00 00 00 00 00 00 00 00 00 00 00 00 00 00 00 00 00 00 00 00 00 00 00 00 00 00 00 00 00 00 00 00 00 00 00 00 00 00 00 00 00 00 00 00 00 00 00 00 00 00 00 00 00 00 00
00 00 00 00 00 00 00 00 00 00 00 00 00 00 00 00 00 00 00 00 00 00 00 00 00 00 00 00 21 13 05 11 19 00 00 00 00 00 00 00 00 00 00 00 00 00 00 00 00 00 00 00 00 00 00 00 00 00 00 00 00 00 00 00 00 00 00 00 00 00 00 00 00 00 00 00 00 00 00 00 00 00 00 00 00 00 00 00 00 00
00 00 00 00 00 00 00 00 00 00 00 00 00 00 00 00 00 00 00 00 00 00 00 00 00 00 00 00 21 13 05 11 19 00 00 00 00 00 00 00 00 00 00 00 00 00 00 00 00 00 00 00 00 00 00 00 00 00 00 00 00 00 00 00 00 00 00 00 00 00 00 00 00 00 00 00 00 00 00 00 00 00 00 00 00 00 00 00 00 00
00 00 00 00 00 00 00 00 00 00 00 00 00 00 00 00 00 00 00 00 00 00 00 00 00 00 00 00 21 13 05 11 19 00 00 00 00 00 00 00 00 00 00 00 00 00 00 00 00 00 00 00 00 00 00 00 00 00 00 00 00 00 00 00 00 03 03 03 03 03 03 03 03 03 03 03 03 03 03 03 03 03 03 00 00 00 00 00 00 00
00 00 00 00 00 00 00 00 00 00 00 00 00 00 00 00 00 00 00 00 00 00 00 00 00 00 00 00 21 13 05 11 19 00 00 00 00 00 00 00 00 00 00 00 00 03 03 03 03 03 03 03 03 03 03 03 03 03 00 00 00 00 00 00 00 03 06 10 10 10 10 10 10 10 10 10 10 10 10 10 10 07 03 00 00 00 00 00 00 00
00 00 00 00 00 00 00 00 00 00 00 00 00 00 00 00 00 00 00 00 00 00 00 00 00 00 00 00 21 09 12 08 19 00 00 00 00 00 00 00 00 00 00 00 00 03 06 10 10 10 10 10 10 10 10 10 07 03 00 00 00 00 00 00 00 03 13 05 05 05 05 05 05 05 05 05 05 05 05 05 05 11 03 00 00 00 00 00 00 00
00 00 00 00 00 00 00 00 00 00 00 00 00 00 00 00 00 00 00 00 00 00 00 00 00 14 18 18 18 04 04 04 18 18 18 15 00 00 00 00 00 00 00 00 00 03 13 05 05 05 05 05 05 05 05 05 11 03 00 00 00 00 00 00 00 03 13 05 05 05 05 05 05 05 05 05 05 05 05 05 05 11 03 00 00 00 00 00 00 00
00 00 00 00 00 00 00 14 18 18 18 18 18 18 18 15 00 00 00 00 00 00 00 00 00 21 06 10 10 10 10 10 10 10 07 19 00 00 00 00 00 00 00 00 00 03 13 05 05 05 05 05 05 05 05 05 11 03 00 00 00 00 00 00 00 03 13 05 05 05 05 05 05 05 05 05 05 05 05 05 05 11 03 00 00 00 00 00 00 00
00 00 00 00 00 00 00 21 06 10 10 10 10 10 07 19 00 00 00 00 00 00 00 00 00 21 13 05 05 05 05 05 05 05 11 19 00 00 00 00 00 00 00 00 00 03 13 05 05 05 05 05 05 05 05 05 11 03 03 03 03 03 03 03 03 03 13 05 05 05 05 05 05 05 05 05 05 05 05 05 05 11 03 00 00 00 00 00 00 00
00 00 00 00 00 00 00 21 13 05 05 05 05 05 11 19 18 18 18 18 18 18 18 18 18 21 13 05 05 05 05 05 05 05 11 19 03 03 03 03 03 03 03 03 03 03 13 05 05 05 05 05 05 05 05 05 11 04 06 10 10 10 10 10 07 04 13 05 05 05 05 05 05 05 05 05 05 05 05 05 05 11 03 00 00 00 00 00 00 00
00 00 00 00 00 00 00 21 13 05 05 05 05 05 11 04 06 10 10 10 10 10 10 10 07 04 13 05 05 05 05 05 05 05 11 04 06 10 10 10 10 10 10 10 07 04 13 05 05 05 05 05 05 05 05 05 11 04 13 05 05 05 05 05 11 04 13 05 05 05 05 05 05 05 05 05 05 05 05 05 05 11 03 00 00 00 00 00 00 00
00 00 00 00 00 00 00 21 13 05 05 05 05 05 11 04 13 05 05 05 05 05 05 05 11 04 13 05 05 05 05 05 05 05 11 04 13 05 05 05 05 05 05 05 11 04 13 05 05 05 05 05 05 05 05 05 11 04 09 12 12 12 12 12 08 04 13 05 05 05 05 05 05 05 05 05 05 05 05 05 05 11 03 00 00 00 00 00 00 00
00 00 00 00 00 00 00 21 13 05 05 05 05 05 11 04 09 12 12 12 12 12 12 12 08 04 13 05 05 05 05 05 05 05 11 04 09 12 12 12 12 12 12 12 08 04 13 05 05 05 05 05 05 05 05 05 11 03 03 03 03 03 03 03 03 03 13 05 05 05 05 05 05 05 05 05 05 05 05 05 05 11 03 00 00 00 00 00 00 00
00 00 00 00 00 00 00 21 13 05 05 05 05 05 11 19 20 20 20 20 20 20 20 20 20 21 13 05 05 05 05 05 05 05 11 19 03 03 03 03 03 03 03 03 03 03 13 05 05 05 05 05 05 05 05 05 11 03 00 00 00 00 00 00 00 03 13 05 05 05 05 05 05 05 05 05 05 05 05 05 05 11 03 00 00 00 00 00 00 00
00 00 00 00 00 00 00 21 09 12 12 12 12 12 08 19 00 00 00 00 00 00 00 00 00 21 13 05 05 05 05 05 05 05 11 19 00 00 00 00 00 00 00 00 00 03 13 05 05 05 05 05 05 05 05 05 11 03 00 00 00 00 00 00 00 03 13 05 05 05 05 05 05 05 05 05 05 05 05 05 05 11 03 00 00 00 00 00 00 00
00 00 00 00 00 00 00 17 20 20 20 20 20 20 20 16 00 00 00 00 00 00 00 00 00 21 09 12 12 12 12 12 12 12 08 19 00 00 00 00 00 00 00 00 00 03 09 12 12 12 12 12 12 12 12 12 08 03 00 00 00 00 00 00 00 03 13 05 05 05 05 05 05 05 05 05 05 05 05 05 05 11 03 00 00 00 00 00 00 00
00 00 00 00 00 00 00 00 00 00 00 00 00 00 00 00 00 00 00 00 00 00 00 00 00 17 20 20 20 04 04 04 20 20 20 16 00 00 00 00 00 00 00 00 00 03 03 03 03 03 04 04 04 03 03 03 03 03 00 00 00 00 00 00 00 03 13 05 05 05 05 05 05 05 05 05 05 05 05 05 05 11 03 00 00 00 00 00 00 00
00 00 00 00 00 00 00 00 00 00 00 00 00 00 00 00 00 00 00 00 00 00 00 00 00 00 00 00 21 06 10 07 19 00 00 00 00 00 00 00 00 00 00 00 00 00 00 00 00 03 06 10 07 03 00 00 00 00 00 00 00 00 00 00 00 03 13 05 05 05 05 05 05 05 05 05 05 05 05 05 05 11 03 00 00 00 00 00 00 00
00 00 00 00 00 00 00 00 00 00 00 00 00 00 00 00 00 00 00 00 00 00 00 00 00 00 00 00 21 13 05 11 19 00 00 00 00 00 00 00 00 00 00 00 00 00 00 00 00 03 13 05 11 03 00 00 00 00 00 00 00 00 00 00 00 03 13 05 05 05 05 05 05 05 05 05 05 05 05 05 05 11 03 00 00 00 00 00 00 00
00 00 00 00 00 00 00 00 00 00 00 00 00 00 00 00 00 00 00 00 00 00 00 00 00 00 00 00 21 13 05 11 19 00 00 00 00 00 00 00 00 00 00 00 00 00 00 00 00 03 13 05 11 03 00 00 00 00 00 00 00 00 00 00 00 03 09 12 12 12 12 12 12 12 12 12 12 12 12 12 12 08 03 00 00 00 00 00 00 00
00 00 00 00 00 00 00 00 00 00 00 00 00 00 00 00 00 00 00 00 00 00 00 00 00 00 00 00 21 13 05 11 19 00 00 00 00 00 00 00 00 00 00 00 00 00 00 00 00 03 13 05 11 03 00 00 00 00 00 00 00 00 00 00 00 03 03 03 03 03 03 03 03 03 03 03 03 03 03 03 03 03 03 00 00 00 00 00 00 00
00 00 00 00 00 00 00 00 00 00 00 00 00 00 00 00 00 00 00 00 00 00 00 00 00 00 00 00 21 13 05 11 19 00 00 00 00 00 00 00 00 00 00 00 00 00 00 00 00 03 13 05 11 03 00 00 00 00 00 00 00 00 00 00 00 00 00 00 00 00 00 00 00 00 00 00 00 00 00 00 00 00 00 00 00 00 00 00 00 00
00 00 00 00 00 00 00 00 00 00 00 00 00 00 00 00 00 00 00 00 00 00 00 00 00 00 00 00 21 09 12 08 19 00 00 00 00 00 00 00 00 00 00 00 00 00 00 00 00 03 13 05 11 03 00 00 00 00 00 00 00 00 00 00 00 00 00 00 00 00 00 00 00 00 00 00 00 00 00 00 00 00 00 00 00 00 00 00 00 00
00 00 00 00 00 00 00 00 00 00 00 00 00 00 00 00 00 00 00 00 00 00 00 14 18 18 18 18 18 04 04 04 18 18 18 18 18 15 00 00 00 00 00 00 00 00 00 00 00 03 13 05 11 03 00 00 00 00 00 00 00 00 00 00 00 00 00 00 00 00 00 00 00 00 00 00 00 00 00 00 00 00 00 00 00 00 00 00 00 00
00 00 00 00 00 00 00 00 00 00 00 00 00 00 00 00 00 00 00 00 00 00 00 21 06 10 10 10 10 10 10 10 10 10 10 10 07 19 00 00 00 00 00 00 00 00 00 00 00 03 13 05 11 03 00 00 00 00 00 00 00 00 00 00 00 00 00 00 00 00 00 00 00 00 00 00 00 00 00 00 00 00 00 00 00 00 00 00 00 00
00 00 00 00 00 00 00 00 00 00 00 00 00 00 00 00 00 00 00 00 00 00 00 21 13 05 05 05 05 05 05 05 05 05 05 05 11 19 00 00 00 00 00 00 00 00 00 00 00 03 09 12 08 03 00 00 00 00 00 00 00 00 00 00 00 00 00 00 00 00 00 00 00 00 00 00 00 00 00 00 00 00 00 00 00 00 00 00 00 00
00 00 00 00 00 00 00 00 00 00 00 00 00 00 00 00 00 00 00 00 00 00 00 21 13 05 05 05 05 05 05 05 05 05 05 05 11 19 00 00 00 00 00 00 00 00 00 03 03 03 04 04 04 03 03 03 00 00 00 00 00 00 00 00 00 00 00 00 00 00 00 00 00 00 00 00 00 00 00 00 00 00 00 00 00 00 00 00 00 00
00 00 00 00 00 00 00 00 00 00 00 00 00 00 00 00 00 00 00 00 00 00 00 21 13 05 05 05 05 05 05 05 05 05 05 05 11 19 00 00 00 00 00 00 00 00 00 03 06 10 10 10 10 10 07 03 00 00 00 00 00 00 00 00 00 00 00 00 00 00 00 00 00 00 00 00 00 00 00 00 00 00 00 00 00 00 00 00 00 00
00 00 00 00 00 00 00 00 00 00 00 00 00 00 00 00 00 00 00 00 00 00 00 21 13 05 05 05 05 05 05 05 05 05 05 05 11 19 03 03 03 03 03 03 03 03 03 03 13 05 05 05 05 05 11 03 00 00 00 00 00 00 00 00 00 00 00 00 00 00 00 00 00 00 00 00 00 00 00 00 00 00 00 00 00 00 00 00 00 00
00 00 00 00 00 00 00 00 00 00 00 00 00 00 00 00 00 00 00 00 00 00 00 21 13 05 05 05 05 05 05 05 05 05 05 05 11 04 06 10 10 10 10 10 10 10 07 04 13 05 05 05 05 05 11 03 00 00 00 00 00 00 00 00 00 00 00 00 00 00 00 00 00 00 00 00 00 00 00 00 00 00 00 00 00 00 00 00 00 00
00 00 00 00 00 00 00 00 00 00 00 00 00 00 00 00 00 00 00 00 00 00 00 21 13 05 05 05 05 05 05 05 05 05 05 05 11 04 13 05 05 05 05 05 05 05 11 04 13 05 05 05 05 05 11 03 00 00 00 00 00 00 00 00 00 00 00 00 00 00 00 00 00 00 00 00 00 00 00 00 00 00 00 00 00 00 00 00 00 00
00 00 00 00 00 00 00 00 00 00 00 00 00 00 00 00 00 00 00 00 00 00 00 21 13 05 05 05 05 05 05 05 05 05 05 05 11 04 09 12 12 12 12 12 12 12 08 04 13 05 05 05 05 05 11 03 00 00 00 00 00 00 00 00 00 00 00 00 00 00 00 00 00 00 00 00 00 00 00 00 00 00 00 00 00 00 00 00 00 00
00 00 00 00 00 00 00 00 00 00 00 00 00 00 00 00 00 00 00 00 00 00 00 21 13 05 05 05 05 05 05 05 05 05 05 05 11 19 03 03 03 03 03 03 03 03 03 03 13 05 05 05 05 05 11 03 00 00 00 00 00 00 00 00 00 00 00 00 00 00 00 00 00 00 00 00 00 00 00 00 00 00 00 00 00 00 00 00 00 00
00 00 00 00 00 00 00 00 00 00 00 00 00 00 00 00 00 00 00 00 00 00 00 21 13 05 05 05 05 05 05 05 05 05 05 05 11 19 00 00 00 00 00 00 00 00 00 03 09 12 12 12 12 12 08 03 00 00 00 00 00 00 00 00 00 00 00 00 00 00 00 00 00 00 00 00 00 00 00 00 00 00 00 00 00 00 00 00 00 00
00 00 00 00 00 00 00 00 00 00 00 00 00 00 00 00 00 00 00 00 00 00 00 21 13 05 05 05 05 05 05 05 05 05 05 05 11 19 00 00 00 00 00 00 00 00 00 03 03 03 04 04 04 03 03 03 00 00 00 00 00 00 00 00 00 00 00 00 00 00 00 00 00 00 00 00 00 00 00 00 00 00 00 00 00 00 00 00 00 00
00 00 00 00 00 00 00 00 00 00 00 00 00 00 00 00 00 00 00 00 00 00 00 21 13 05 05 05 05 05 05 05 05 05 05 05 11 19 00 00 00 00 00 00 00 00 00 00 00 03 06 10 07 03 00 00 00 00 00 00 00 00 00 00 00 00 00 00 00 00 00 00 00 00 00 00 00 00 00 00 00 00 00 00 00 00 00 00 00 00
00 00 00 00 00 00 00 00 00 00 00 00 00 00 00 00 00 00 00 00 00 00 00 21 09 12 12 12 12 12 12 12 12 12 12 12 08 19 00 00 00 00 00 00 00 00 00 00 00 03 13 05 11 03 00 00 00 00 00 00 00 00 00 00 00 00 00 00 00 00 00 00 00 00 00 00 00 00 00 00 00 00 00 00 00 00 00 00 00 00
00 00 00 00 00 00 00 00 00 00 00 00 00 00 00 00 00 00 00 00 00 00 00 17 20 20 20 20 20 20 20 20 20 20 20 20 20 16 00 00 00 00 00 00 00 00 00 00 00 03 13 05 11 03 00 00 00 00 00 00 00 00 00 00 00 00 00 00 00 00 00 00 00 00 00 00 00 00 00 00 00 00 00 00 00 00 00 00 00 00
00 00 00 00 00 00 00 00 00 00 00 00 00 00 00 00 00 00 00 00 00 00 00 00 00 00 00 00 00 00 00 00 00 00 00 00 00 00 00 00 00 00 00 00 00 00 00 00 00 03 13 05 11 03 00 00 00 00 00 00 00 00 00 00 00 00 00 00 00 00 00 00 00 00 00 00 00 00 00 00 00 00 00 00 00 00 00 00 00 00
00 00 00 00 00 00 00 00 00 00 00 00 00 00 00 00 00 00 00 00 00 00 00 00 00 00 00 00 00 00 00 00 00 00 00 00 00 00 00 00 00 00 00 00 00 00 00 00 00 03 13 05 11 03 00 00 00 00 00 00 00 00 00 00 00 00 00 00 00 00 00 00 00 00 00 00 00 00 00 00 00 00 00 00 00 00 00 00 00 00
00 00 00 00 00 00 00 00 00 00 00 00 00 00 00 00 00 00 00 00 00 00 00 00 00 00 00 00 00 00 00 00 00 00 00 00 00 00 00 00 00 00 00 00 00 00 00 00 00 03 13 05 11 03 00 00 00 00 00 00 00 00 00 00 00 00 00 00 00 00 00 00 00 00 00 00 00 00 00 00 00 00 00 00 00 00 00 00 00 00
00 00 00 00 00 00 00 00 00 00 00 00 00 00 00 00 00 00 00 00 00 00 00 00 00 00 00 00 00 00 00 00 00 00 00 00 00 00 00 00 00 00 00 00 00 00 00 00 00 03 13 05 11 03 00 00 00 00 00 00 00 00 00 00 00 00 00 00 00 00 00 00 00 00 00 00 00 00 00 00 00 00 00 00 00 00 00 00 00 00
00 00 00 00 00 00 00 00 00 00 00 00 00 00 00 00 00 00 00 00 00 00 00 00 00 00 00 00 00 00 00 00 00 00 00 00 00 00 00 00 00 00 00 00 00 00 00 00 00 03 09 12 08 03 00 00 00 00 00 00 00 00 00 00 00 00 00 00 00 00 00 00 00 00 00 00 00 00 00 00 00 00 00 00 00 00 00 00 00 00
00 00 00 00 00 00 00 00 00 00 00 00 00 00 00 00 00 00 00 00 00 00 00 00 00 00 00 00 00 00 00 00 00 00 00 00 00 00 00 00 00 00 00 00 03 03 03 03 03 03 04 04 04 03 03 03 03 03 03 00 00 00 00 00 00 00 00 00 00 00 00 00 00 00 00 00 00 00 00 00 00 00 00 00 00 00 00 00 00 00
00 00 00 00 00 00 00 00 00 00 00 00 00 00 00 00 00 00 00 00 00 00 00 00 00 00 00 00 00 00 00 00 00 00 00 00 00 00 00 00 00 00 00 00 03 06 10 10 10 10 10 10 10 10 10 10 10 07 03 00 00 00 00 00 00 00 00 00 00 00 00 00 00 00 00 00 00 00 00 00 00 00 00 00 00 00 00 00 00 00
00 00 00 00 00 00 00 00 00 00 00 00 00 00 00 00 00 00 00 00 00 00 00 00 00 00 00 00 00 00 00 00 00 00 00 00 00 00 00 00 00 00 00 00 03 13 05 05 05 05 05 05 05 05 05 05 05 11 03 00 00 00 00 00 00 00 00 00 00 00 00 00 00 00 00 00 00 00 00 00 00 00 00 00 00 00 00 00 00 00
00 00 00 00 00 00 00 00 00 00 00 00 00 00 00 00 00 00 00 00 00 00 00 00 00 00 00 00 00 00 00 00 00 00 00 00 00 00 00 00 00 00 00 00 03 13 05 05 05 05 05 05 05 05 05 05 05 11 03 00 00 00 00 00 00 00 00 00 00 00 00 00 00 00 00 00 00 00 00 00 00 00 00 00 00 00 00 00 00 00
00 00 00 00 00 00 00 00 00 00 00 00 00 00 00 00 00 00 00 00 00 00 00 00 00 00 00 00 00 00 00 00 00 00 00 00 00 00 00 00 00 00 00 00 03 13 05 05 05 05 05 05 05 05 05 05 05 11 03 00 00 00 00 00 00 00 00 00 00 00 00 00 00 00 00 00 00 00 00 00 00 00 00 00 00 00 00 00 00 00
00 00 00 00 00 00 00 00 00 00 00 00 00 00 00 00 00 00 00 00 00 00 00 00 00 00 00 00 00 00 00 00 00 00 00 00 00 00 00 00 00 00 00 00 03 13 05 05 05 05 05 05 05 05 05 05 05 11 03 00 00 00 00 00 00 00 00 00 00 00 00 00 00 00 00 00 00 00 00 00 00 00 00 00 00 00 00 00 00 00
00 00 00 00 00 00 00 00 00 00 00 00 00 00 00 00 00 00 00 00 00 00 00 00 00 00 00 00 00 00 00 00 00 00 00 00 00 00 00 00 00 00 00 00 03 13 05 05 05 05 05 05 05 05 05 05 05 11 03 00 00 00 00 00 00 00 00 00 00 00 00 00 00 00 00 00 00 00 00 00 00 00 00 00 00 00 00 00 00 00
00 00 00 00 00 00 00 00 00 00 00 00 00 00 00 00 00 00 00 00 00 00 00 00 00 00 00 00 00 00 00 00 00 00 00 00 00 00 00 00 00 00 00 00 03 13 05 05 05 05 05 05 05 05 05 05 05 11 03 00 00 00 00 00 00 00 00 00 00 00 00 00 00 00 00 00 00 00 00 00 00 00 00 00 00 00 00 00 00 00
00 00 00 00 00 00 00 00 00 00 00 00 00 00 00 00 00 00 00 00 00 00 00 00 00 00 00 00 00 00 00 00 00 00 00 00 00 00 00 00 00 00 00 00 03 13 05 05 05 05 05 05 05 05 05 05 05 11 03 00 00 00 00 00 00 00 00 00 00 00 00 00 00 00 00 00 00 00 00 00 00 00 00 00 00 00 00 00 00 00
00 00 00 00 00 00 00 00 00 00 00 00 00 00 00 00 00 00 00 00 00 00 00 00 00 00 00 00 00 00 00 00 00 00 00 00 00 00 00 00 00 00 00 00 03 13 05 05 05 05 05 05 05 05 05 05 05 11 03 00 00 00 00 00 00 00 00 00 00 00 00 00 00 00 00 00 00 00 00 00 00 00 00 00 00 00 00 00 00 00
00 00 00 00 00 00 00 00 00 00 00 00 00 00 00 00 00 00 00 00 00 00 00 00 00 00 00 00 00 00 00 00 00 00 00 00 00 00 00 00 00 00 00 00 03 13 05 05 05 05 05 05 05 05 05 05 05 11 03 00 00 00 00 00 00 00 00 00 00 00 00 00 00 00 00 00 00 00 00 00 00 00 00 00 00 00 00 00 00 00
00 00 00 00 00 00 00 00 00 00 00 00 00 00 00 00 00 00 00 00 00 00 00 00 00 00 00 00 00 00 00 00 00 00 00 00 00 00 00 00 00 00 00 00 03 13 05 05 05 05 05 05 05 05 05 05 05 11 03 00 00 00 00 00 00 00 00 00 00 00 00 00 00 00 00 00 00 00 00 00 00 00 00 00 00 00 00 00 00 00
00 00 00 00 00 00 00 00 00 00 00 00 00 00 00 00 00 00 00 00 00 00 00 00 00 00 00 00 00 00 00 00 00 00 00 00 00 00 00 00 00 00 00 00 03 09 12 12 12 12 12 12 12 12 12 12 12 08 03 00 00 00 00 00 00 00 00 00 00 00 00 00 00 00 00 00 00 00 00 00 00 00 00 00 00 00 00 00 00 00
00 00 00 00 00 00 00 00 00 00 00 00 00 00 00 00 00 00 00 00 00 00 00 00 00 00 00 00 00 00 00 00 00 00 00 00 00 00 00 00 00 00 00 00 03 03 03 03 03 03 03 03 03 03 03 03 03 03 03 00 00 00 00 00 00 00 00 00 00 00 00 00 00 00 00 00 00 00 00 00 00 00 00 00 00 00 00 00 00 00
00 00 00 00 00 00 00 00 00 00 00 00 00 00 00 00 00 00 00 00 00 00 00 00 00 00 00 00 00 00 00 00 00 00 00 00 00 00 00 00 00 00 00 00 00 00 00 00 00 00 00 00 00 00 00 00 00 00 00 00 00 00 00 00 00 00 00 00 00 00 00 00 00 00 00 00 00 00 00 00 00 00 00 00 00 00 00 00 00 00
00 00 00 00 00 00 00 00 00 00 00 00 00 00 00 00 00 00 00 00 00 00 00 00 00 00 00 00 00 00 00 00 00 00 00 00 00 00 00 00 00 00 00 00 00 00 00 00 00 00 00 00 00 00 00 00 00 00 00 00 00 00 00 00 00 00 00 00 00 00 00 00 00 00 00 00 00 00 00 00 00 00 00 00 00 00 00 00 00 00
00 00 00 00 00 00 00 00 00 00 00 00 00 00 00 00 00 00 00 00 00 00 00 00 00 00 00 00 00 00 00 00 00 00 00 00 00 00 00 00 00 00 00 00 00 00 00 00 00 00 00 00 00 00 00 00 00 00 00 00 00 00 00 00 00 00 00 00 00 00 00 00 00 00 00 00 00 00 00 00 00 00 00 00 00 00 00 00 00 00