30 15
1200 400
0 0 0 0 0 0 0 0 0 0 0 0 0 0 0 0 0 0 0 0 0 0 0 0 0 0 0 0 0 0
0 0 0 0 0 0 0 0 0 0 0 0 0 0 0 0 0 0 0 0 0 0 0 0 0 0 0 0 0 0
0 0 0 0 0 0 0 0 0 0 0 0 0 0 0 0 0 0 0 0 0 0 0 0 0 0 0 0 0 0
0 0 0 0 0 0 0 3 3 3 3 3 3 3 3 3 0 0 0 0 0 0 0 0 0 0 0 0 0 0
0 0 0 0 0 0 0 3 2 2 2 2 2 2 2 3 0 0 0 0 3 3 3 0 0 0 0 0 0 0
0 0 0 0 0 0 0 3 2 2 2 2 2 2 2 3 3 3 3 3 3 2 3 0 0 0 0 0 0 0
0 0 0 0 0 0 0 3 2 2 2 2 2 2 2 4 2 2 2 2 2 2 3 0 0 0 0 0 0 0
0 0 0 0 0 0 0 3 2 2 2 2 2 2 2 4 2 2 2 2 2 2 3 0 0 0 0 0 0 0
0 0 0 0 0 0 0 3 2 2 2 2 2 2 2 4 2 2 2 2 2 2 3 0 0 0 0 0 0 0
0 0 0 0 0 0 0 3 2 2 2 2 2 2 2 3 3 3 3 3 3 2 3 0 0 0 0 0 0 0
0 0 0 0 0 0 0 3 2 2 2 2 2 2 2 3 0 0 0 0 3 3 3 0 0 0 0 0 0 0
0 0 0 0 0 0 0 3 3 3 3 3 3 3 3 3 0 0 0 0 0 0 0 0 0 0 0 0 0 0
0 0 0 0 0 0 0 0 0 0 0 0 0 0 0 0 0 0 0 0 0 0 0 0 0 0 0 0 0 0
0 0 0 0 0 0 0 0 0 0 0 0 0 0 0 0 0 0 0 0 0 0 0 0 0 0 0 0 0 0
0 0 0 0 0 0 0 0 0 0 0 0 0 0 0 0 0 0 0 0 0 0 0 0 0 0 0 0 0 0